+-+-e-+-+
| |z|z|y|
+-+-+-+-+
|z|y| |z|
+-+-+-+-+
|z| |y|z|
+-+-+-+-+
|y|z|z| |
+-+-s-+-+