+-+-+e+-+-+
|z|z|v| | |
+-+-+-+-+-+
|v|v|v|z|o|
+-+-+-+-+-+
|z|z| |z o|
+-+ +-+-+-+
|o|o| | | |
+-+-+s+-+-+