+-+-e-+-+
|x|x|z|z|
+-+-+-+-+
|x|x|y|y|
+-+-+-+-+
|y|y|y|y|
+-+-s-+-+