+-+-+-+-+-e
|a| | | |b|
+-+-+-+-+-+
| | | | | |
+-+-+-+-+-+
| | | | | |
+-+-+-+-+-+
| | | | | |
+-+-+-+-+-+
| |c| | |d|
s-+-+-+-+-+