+-+-+-+-e
| | |d| |
+-+-+-+-+
| | | | |
+-+-+-+-+
| | | |c|
+-+-+-+-+
|a| | |b|
s-+-+-+-+