+-+-e-+-+
| |a|a| |
+-+-+-+-+
| |z| |b|
+-+-+-+-+
| | | | |
+-+-+-+-+
| | |z| |
+-+-s-+-+