e-+-+-+-+
|a| |b| |
+-+-+-+-+
| | | |c|
+-+-+-+-+
|b| | | |
+-+-+-+-+
| | | | |
s-+-+-+-+