+-+-+-+-+-+-e
|w|w| | |z|y|
+-+-+-+-+-+-+
|x|w| | |z|z|
+-+-+-+-+-+-+
| | | | | | |
+-+-+-+-+-+-+
| | | | | | |
+-+-+-+-+-+-+
|y|y| | |x|w|
+-+-+-+-+-+-+
|z|y| | |x|x|
s-+-+-+-+-+-+