+-+-+e+-+-+
|z| |b| | |
+-+-+-+-+-+
| | |b| | |
+-+-+-+-+-+
ev|v| |v|ve
+-+-+-+-+-+
| | |b| | |
+-+-+-+-+-+
| | |b| |z|
+-+-+s+-+-+