+-+-e-+-+
|b|b|o|o|
+-+-+-+-+
|b|b|o|o|
+-+-+-+-+
| | | | |
+-+-+-+-+
| | | |z|
+-+-s-+-+