+-+-+-+-+-e
|a|a|a|a|a|
+-+-+-+-+-+
| | | | | |
+-+-+-+-+-+
| | |z| | |
+-+-+-+-+-+
| | | | | |
+-+-+-+-+-+
|z|z|z|z|z|
s-+-+-+-+-+