+-+-e-+-+
| | | |v|
+-+-+-+-+
|z|z|b| |
+-+-+-+-+
|v| |z| |
+-+-+-+-+
| |v|z| |
+-+-s-+-+