+-+-+-+-e
|a| | |c|
+-+-+-+-+
| | | | |
+-+-+-+-+
| | | | |
+-+-+-+-+
|b| | | |
s-+-+-+-+