+-+-+-+-e
|a|a| | |
+-+-+-+-+
| | | | |
+-+ +-+-+
| | | | |
+-+-+ +-+
| | | | |
s-+-+-+-+