+-e-+-+-+
|d| | | |
+-+-+-+-+
| | | | |
+-+-+-+-+
| | | | |
+-+-+-+-+
| | | | |
+-+-+-+-+
| | | | |
+-+-+-+-+
| | | |f|
+-s-+-+-+