+-+-+e+-+-+
|z|z|v| | |
+-+-+-+-+-+
|o|o| | | |
+-+-+s+-+-+