+-+-+e+-+-+
| | | | | |
+-+-+-+-+-+
| | | | |a|
+-+-+-+-+-+
| | | | |b|
+-+-+s+-+-+