+-+-+-+-e
| | |b| |
+-+-+-+-+
| | | | |
+-+-+-+-+
| | | | |
+-+-+-+-+
| | |c|a|
s-+-+-+-+