b-+-+-+-+-b-e
| | | | | | |
+-+-+-+-+-+b+
| | | | | | |
+-+-+-+-+-+-+
| | | | | | |
s-+-+-+-+-+-s
| | | | | | |
+-+-b-+-+y+-+
| | | | | | |
+-+-+-+-+-+-+
| | | | | y |
e-+-+-+-+-+-+