+-+-+-+-b-b-+
| | | | | | |
s-+-+-+-+-+-s
| | | | | | |
+-+-+-+-+-b-e
| | | | | | |
e-+-+-+-y-+-+
| | | | | | |
s-+-+-+-+-+-s
| | | | | | |
+-+-+-+-+-+-+