s-+-+-+-+-y-+
| | | | | | |
+-+-+-+-+-+-+
| | | | | | |
+-+-y-+-+-+-e
| | | | | | |
e-y-+-+-+-+-+
| | | | | | |
+-+-+-+-+-+-+
| | | | | | |
+-+-+-+-+-+-s