s-+-+-+-+-+-+
| | | | y | |
+-+-+-+-+-+b+
| | | | | | |
+-+-+-+-+-+-e
| | | | | | |
e-+-+-+-b-+-+
| | | | | | |
+-+-+-+-+-+-+
| | | | | | |
+-+-+-+-+-+-s