+-+-+-+-+-+-e
| | | | | | |
+-+-+-+-+-+b+
| | | | | | |
+-+-+-+-+-+-+
| | | | | | |
s-+-+-+-+-+-s
| | | | | | |
+-+-b-+-+-+-+
| | | | | | |
+-+-+-+-+-+-+
| | | | | | |
e-+-+-+-+-+-+