+-+-+-+-+-e
| | |m| | |
+-+-+-+-+-+
|l| | |l|m|
+-+ +-+ +-+
|m|l|m| | |
+-+ +-+ +-+
| |l|m| | |
+-+ +-+ +-+
|m| | |l|l|
s-+ +-+ +-+