+-+       +-e
| |  x    | |
+-+-+-+-+-+-+
|l| | |x| |m|
+-+-+-+-+-+-+
 x| | | | |x|
  +-+-+-+-+-+
 x| | | | |x|
  +-+-s-+-+-+