+-+-e-+-+
|z|z|y|y|
+-+-+-+-+
|z| | |y|
+-+-+-+-+
|y| | |z|
+-+-+-+-+
|y|y|z|z|
+-+-s-+-+