+ +-+-+-e
|x| |l|l|
+-+-+-+ +
| | |m| |
+-+-+-+-+
| |l|   |
+-+-+-+-+
|m|m  |x|
s-+-+-+-+