+-+-+-+-+-e
|l| | | | |
+-+-+-+-+-+
| | |b| |l|
+-+-+-+-+-+
| | |a| | |
+-+-+-+-+-+
|m| | | | |
+-+-+-+-+-+
| | | | |m|
s-+-+-+-+-+