+-+-+-+-+-e
| | |a| | |
+-+-+-+-+-+
| | | | | |
+-+-+-+-+-+
|b| | | |b|
+-+-+-+-+-+
| | | | | |
+-+-+-+-+-+
| | |d| | |
s-+-+-+-+-+