+-+-+-+-+-e
| | |b| | |
+-+-+-+-+-+
| |   | | |
+-+-+-+ +-+
| | | | | |
+-+-+-+-+-+
| | | | | |
+-+-+-+-+-+
|a| | | |c|
s-+-+-+-+-+