+-+-e-+-+
|z|y| |z|
+-+-+-+-+
|y|y| | |
+-+-+-+-+
| | |y|y|
+-+-+-+-+
|z| |y|z|
+-+-s-+-+