+-+-+-+-+-e
| |l|m| | |
+-+-+-+-+-+
| | | | | |
+-+-+-+-+-+
| | |a|m|b|
+-+-+-+-+-+
| | | | | |
+-+-+-+-+-+
|l| | | |m|
s-+-+-+-+-+