+-+-+-+-+-e
| | | | | |
+-+-+-+-+-+
|a| | | | |
+-+-+-+-+-+
| | | |b| |
+-+-+-+-+-+
| | | | | |
+-+-+-+-+-+
|c| | | | |
s-+-+-+-+-+