+-+-+e+-+-+
| |z| | | |
+-+-+-+-+-+
|y| | | | |
+-+-+-+-+-+
| | | |b|z|
+-+-+-+-+-+
| |a| | | |
+-+-+-+-+-+
| | | |c|y|
+-+-+s+-+-+