+-+-e-+-+
| | | |z|
+-+-+-+-+
| |c| | |
+-+-+-+-+
| | | | |
+-+-+-+-+
| |z|b| |
s-+-+-+-+