+-+-+-+-+-+-e
| | | | | | |
+-+-+-+-+-+-+
| | | |y| | |
+-+-+-+-+-+-+
| | |l|l| |a|
+-+-+-+-+-+-+
| | |m|m| | |
+-+-+-+-+-+-+
| | | | | |z|
+-+-+-+-+-+-+
| | |l| | | |
s-+-+-+-+-+-+