+-+-+-+-+-e
| | | |b| |
+-+ +-+-+-+
| | | | | |
+-+-+-+-+ +
|b| | | | |
+-+-+-+-+-+
|   | | | |
+-+-+-+ +-+
|c| | | | |
s-+-+-+-+-+