+-+-+-e-+-+-+
| | |b| | |z|
+-+-+-+-+-+-+
| | | | | | |
+-+-+-+-+-+-+
| | |a| | | |
+-+-+-+-+-+-+
| | | | | | |
+-+-+-+-+-+-+
| | |c| | | |
+-+-+-+-+-+-+
|z| | | | |z|
+-+-+-s-+-+-+