+-+-+-+-+-e
|x| | |w| |
+-t-+-+-+-+
| | |a| |b|
+-+-+-+-+-+
|c| | | |l|
+-+-+-+-+-+
|l| | | | |
+-+-+-+-+-+
| | |m|x|w|
s-+-+-+-+-+