+-+-+-+-+-+-+-+-e
| | | | | | | | |
+-+-+-+-+-+-+-+-+
| |d| | | | |d| |
+-+-+-+-+-+-+-+-+
| | | | | | | | |
+-+-+-+-+-+-+-+-+
| | | | | | | | |
+-+-+-+-+-+-+-+-+
| |d| | | | |d| |
+-+-+-+-+-+-+-+-+
| | | | | | | | |
s-+-+-+-+-+-+-+-+