+-+-+-+-+-+-+-+-e
| | | | | | | | |
+-+-+-+-+-+-+-+-+
| |a| | | | |a| |
+-+-+-+-+-+-+-+-+
| | | | | | | | |
+-+-+-+-+-+-+-+-+
| | | | | | | | |
+-+-+-+-+-+-+-+-+
| |a| | | | |a| |
+-+-+-+-+-+-+-+-+
| | | | | |a|a| |
s-+-+-+-+-+-+-+-+