+-e-+-+-+
|b| | | |
+-+-+-+-+
| | | | |
+-+-+-+-+
|a| | | |
+-+-+-+-+
| | | | |
+-+-+-+-+
|c| | | |
+-+-+-+-+
| | | |z|
+-s-+-+-+